MAP START
#########################
# G                     #
#                 G     #
#  ###########          #
#            #          #
#            # G        #
#            ####       #
# G          ####       #
#               #     G #
#               #       #
#  G ####       #       #
#    ####       #       #
#    ####       #  G    #
#    ####       ####    #
#  P                    #
#      G                #
#########################
MAP END