MAP START
#########################
# G                     #
#        M        G     #
#  ###########          #
#            # M        #
# M          # G        #
#            ####       #
# G          ####       #
#               # M   G #
#         M     #       #
#  G ####       #       #
#    ####       #       #
#    ####       # MG    #
#    ####       ####    #
#  P                  M #
#      G                #
#########################
MAP END